30 36
####################################
#                                  #
# ##     ##   # ####    # #####    #
#  ##   ##    #         #          #
#   ## ##     #   P     #          #
#    ###      # ####    # ### #    #
#     #       #               #    #
#     #       #          S    #    #
#  S  #       # ####    ##### #    #
#                                  #
# ##   ## ######## ##BBB## ## # ## #
# ###  ## ######## ##BBB## ## #P## #
# #### ##    ##    ##BBB## ## # ## #
# ## ####    ##    ####### ## # ## #
# ##  ###    ##    ####### ##   ## #
# ##   ##    ##    ##   ## ####### #
# ##   ##    ##    ##   ## ####### #
#.               C                 #
#       P                          #
# # #### # ####   ##### #  # ##### #
# #      #              #  #       #
# #      #              #  #       #
# #      # ## #   # ### #  # ### # #
# #           #   #......  ......# #
# #           #   # S      ......# #
# # #### #### #   # #####  ##### # #
#...      ......    ......      ...#
# S   ......    C       ......     #
#...            ......          ...#
####################################
